Názov: Nepribližujte sa!
Panely: U

N 1 N 1 N 1 N 1 N 1 N 1 N 1 N 1 N 1 N 1 N 1 N 1 N
1 _ 0 _ 0 _ 0 _ 0 _ 0 v 0 _ 0 _ 0 _ 0 _ 0 _ 0 _ 1
N 0 N 0 N 0 N 0 N 0 N 0 N 0 N 0 N 1 N 0 N 0 N 0 N
1 _ 0 _ 0 _ 0 v 0 _ 0 _ 0 _ 0 v 0 _ 0 _ 0 _ 0 _ 1
N 0 N 0 N 0 N 0 N 0 N 0 N 1 N 0 N 0 N 0 N 0 N 0 N
1 _ 0 v 0 _ 0 _ 0 _ 0 _ 0 _ 0 _ 0 _ 0 v 0 _ 0 S 1
N 0 N 0 N 0 N 0 N 1 N 0 N 0 N 0 N 0 N 0 N 0 N 0 N
1 _ 0 _ 0 _ 0 _ 0 _ 0 _ 0 _ 0 _ 0 _ 0 _ 0 _ 0 X 1
N 0 N 0 N 1 N 0 N 0 N 0 N 0 N 0 N 0 N 0 N 0 N 0 N
1 → 0 _ 0 _ 0 _ 0 _ 0 _ 0 _ 0 _ 0 _ 0 _ 0 _ 0 _ 1
N 0 N 0 N 1 N 0 N 0 N 0 N 0 N 0 N 0 N 0 N 0 N 0 N
1 _ 0 _ 0 _ 0 _ 0 _ 0 _ 0 _ 0 _ 0 _ 0 _ 0 _ 0 X 1
N 0 N 0 N 0 N 0 N 1 N 0 N 0 N 0 N 0 N 0 N 0 N 0 N
1 _ 0 ^ 0 _ 0 _ 0 _ 0 _ 0 _ 0 _ 0 _ 0 ^ 0 _ 0 S 1
N 0 N 0 N 0 N 0 N 0 N 0 N 1 N 0 N 0 N 0 N 0 N 0 N
1 _ 0 _ 0 _ 0 ^ 0 _ 0 _ 0 _ 0 ^ 0 _ 0 _ 0 _ 0 _ 1
N 0 N 0 N 0 N 0 N 0 N 0 N 0 N 0 N 1 N 0 N 0 N 0 N
1 _ 0 _ 0 _ 0 _ 0 _ 0 ^ 0 _ 0 _ 0 _ 0 _ 0 _ 0 _ 1
N 1 N 1 N 1 N 1 N 1 N 1 N 1 N 1 N 1 N 1 N 1 N 1 N