Názov: Uteč!
Panely: D

N 1 N 1 N 1 N 1 N 1 N 1 N 1 N 1 N 1 N 1 N 1 N 1 N
1 _ 0 _ 0 _ 0 _ 0 _ 0 _ 1 _ 0 _ 0 _ 0 _ 0 _ 0 _ 1
N 0 N 1 N 1 N 1 N 1 N 0 N 0 N 1 N 1 N 1 N 1 N 0 N
1 _ 1 _ 0 _ 0 _ 0 _ 0 _ 0 _ 1 _ 0 _ 0 _ 0 _ 1 _ 1
N 0 N 0 N 0 N 0 N 0 N 0 N 0 N 0 N 0 N 0 N 0 N 0 N
1 _ 1 _ 0 _ 0 _ 0 _ 0 _ 1 _ 1 _ 0 _ 0 S 0 _ 1 _ 1
N 0 N 1 N 1 N 1 N 1 N 1 N 0 N 1 N 1 N 1 N 0 N 0 N
1 _ 0 _ 0 _ 0 _ 0 _ 0 _ 0 _ 0 _ 0 _ 0 _ 0 _ 0 _ 1
N 1 N 1 N 1 N 1 N 1 N 1 N 0 N 1 N 1 N 1 N 0 N 1 N
1 _ 0 _ 0 _ 0 _ 0 _ 0 v 1 _ 0 _ 0 _ 0 _ 0 _ 0 _ 1
N 0 N 1 N 1 N 1 N 0 N 0 N 1 N 1 N 1 N 1 N 0 N 0 N
1 _ 1 _ 0 _ 0 _ 1 _ 1 _ 1 _ 0 _ 0 _ 0 _ 0 _ 1 _ 1
N 0 N 0 N 1 N 0 N 0 N 0 N 0 N 0 N 0 N 0 N 1 N 0 N
1 _ 1 _ 0 _ 0 _ 0 _ 0 _ 0 _ 0 _ 0 _ 0 _ 0 _ 1 _ 1
N 0 N 0 N 0 N 0 N 0 N 0 N 0 N 0 N 0 N 0 N 0 N 0 N
1 _ 1 _ 1 _ 0 _ 0 _ 0 _ 1 _ 0 _ 0 _ 0 _ 0 _ 1 _ 1
N 0 N 0 N 0 N 1 N 0 N 0 N 1 N 1 N 1 N 1 N 1 N 0 N
1 _ 1 _ 0 _ 0 _ 0 _ 1 → 0 _ 0 _ 0 _ 0 → 0 _ 0 _ 1
N 1 N 1 N 1 N 1 N 1 N 1 N 1 N 1 N 1 N 1 N 1 N 1 N