S S S S S S S S S S S S S S S S S S
S . . S . . S . . . . . . S . . . S
S . . S . . S . . S . . . S . . . S
S S . S S . S . . S . . . S . . . S
S . . . . . . . . S . . . . . . . S
S . . . . . . . . S . . . S . . . S
S S S S S S S S S S S S S S . . . S
S S . . . . . . . . . . . S . . . S
S S . S . S . S . S . . . S . . . S
S S . . . . . . . . . . . . . . . S
D . . . . . . . . . . . . . . . . S
S S . . . . . . . . . . . . . . . S
S S . S . S . S . S . . . S . S . S
S S . . . . . . . . . . . S . . . S
S S S S S S S S S S S S S S S S S S