######
#XSCX#
#C C #
#  X #
######